000000000221010202
111111111120020210
110001110210212021
000101010212021200
101010000212010201
000101000102120100